1111111111111111111111111
1001001000001000000000001
1001001111001001111111111
1V000000000010010E0001001
11110011110010010V1001001
1000001001000001001000001
10011110011110C1111111001
10000000000V1000000000001
10010000V0000000001000001
1001111CC1111111001C01111
100CC00000V110010C1001001
11111110011110010010C1001
100C00000100V0000010C1001
11110010010010011110000C1
10P0010010010V0000C0000V1
1111111111111111111111111