1111111111111111111111111
1001001000001000000000001
1001001111001001111111111
10000000000010010E0001001
1111001111001001001001001
1000001001000001001000001
10011110011110C1111111001
1000000000001000000000001
1001000000000000001000001
1001111CC1111111001C01111
100CC000000110010C1001001
11111110011110010010C1001
100C0000010000000010C1001
11110010010010011110000C1
10P001001001000000C000001
1111111111111111111111111